{


  "birthday_party": [

    { "MAPA_ARCADE": "01",
      "blockers": 90,
      "grid": [
        [3,0,0,0,1,0,0,0,0,0,1,0,0,0,3],
        [0,1,0,1,1,0,1,0,1,0,1,1,0,1,0],
        [0,0,0,0,0,0,0,0,0,0,0,0,0,0,0],
        [0,1,7,1,1,0,1,1,1,0,1,1,7,1,0],
        [0,7,4,7,0,0,0,0,0,0,0,7,4,7,0],
        [0,1,7,1,1,0,2,2,2,0,1,1,7,1,0],
        [1,0,0,0,0,0,2,2,2,0,0,0,0,0,1],
        [0,1,7,1,1,0,2,2,2,0,1,1,7,1,0],
        [0,7,4,7,0,0,0,0,0,0,0,7,4,7,0],
        [0,1,7,1,1,0,1,1,1,0,1,1,7,1,0],
        [0,0,0,0,0,0,0,0,0,0,0,0,0,0,0],
        [0,1,0,1,1,0,1,0,1,0,1,1,0,1,0],
        [3,0,0,0,1,0,0,0,0,0,1,0,0,0,3]
      ]
    },
    { "MAPA_ARCADE": "02",
      "blockers": 90,
      "grid": [
        [3,0,0,0,1,0,0,0,0,0,1,0,0,0,3],
        [0,1,0,1,1,0,1,7,1,0,1,1,0,1,0],
        [0,0,0,0,1,0,7,4,7,0,1,0,0,0,0],
        [1,1,1,0,0,0,1,7,1,0,0,0,1,1,1],
        [0,0,0,0,1,0,0,0,0,0,1,0,0,0,0],
        [0,1,7,1,1,0,2,2,2,0,1,1,7,1,0],
        [0,7,4,7,0,0,2,2,2,0,0,7,4,7,0],
        [0,1,7,1,1,0,2,2,2,0,1,1,7,1,0],
        [0,0,0,0,1,0,0,0,0,0,1,0,0,0,0],
        [1,1,1,0,0,0,1,7,1,0,0,0,1,1,1],
        [0,0,0,0,1,0,7,4,7,0,1,0,0,0,0],
        [0,1,0,1,1,0,1,7,1,0,1,1,0,1,0],
        [3,0,0,0,1,0,0,0,0,0,1,0,0,0,3]
      ]
    },
	{ "MAPA_ARCADE": "03",
      "blockers": 90,
      "grid": [
        [3,0,0,0,0,0,0,0,0,0,0,0,0,0,3],
        [0,1,1,0,1,1,0,0,0,1,1,0,1,1,0],
        [0,0,1,7,1,0,0,1,0,0,1,7,1,0,0],
        [1,0,7,4,7,0,1,1,1,0,7,4,7,0,1],
        [0,0,1,7,1,0,0,0,0,0,1,7,1,0,0],
        [0,1,0,0,0,0,2,2,2,0,0,0,0,1,0],
        [0,0,0,1,0,0,2,2,2,0,0,1,0,0,0],
        [0,1,0,0,0,0,2,2,2,0,0,0,0,1,0],
        [0,0,1,7,1,0,0,0,0,0,1,7,1,0,0],
        [1,0,7,4,7,0,1,1,1,0,7,4,7,0,1],
        [0,0,1,7,1,0,0,1,0,0,1,7,1,0,0],
        [0,1,1,0,1,1,0,0,0,1,1,0,1,1,0],
        [3,0,0,0,0,0,0,0,0,0,0,0,0,0,3]
      ]
    }
  ],

  "candy_factory": [

    { "MAPA_ARCADE": "01",
      "blockers": 70,
	  "conveyor_belt": [[7,8],[7,10],[11,10],[11,2],[3,2],[3,10],[5,10]],
      "grid": [
        [3,0,0,0,0,0,0,0,0,0,0,0,0,0,3],
        [0,1,1,1,0,1,1,1,1,1,0,1,1,1,0],
        [0,0,1,5,5,5,5,5,5,5,5,5,1,0,0],
        [1,0,0,5,1,1,1,0,1,1,1,5,0,0,1],
        [1,0,1,5,0,0,0,0,0,0,0,5,1,0,1],
        [1,0,1,5,1,0,2,2,2,0,1,5,1,0,1],
        [0,0,1,5,1,0,2,2,2,0,1,5,1,0,0],
        [1,0,1,5,1,0,2,2,2,0,1,5,1,0,1],
        [1,0,1,5,0,0,0,5,0,0,0,5,1,0,1],
        [1,0,0,5,1,1,1,5,1,1,1,5,0,0,1],
        [0,0,1,5,5,5,0,5,5,5,5,5,1,0,0],
        [0,1,1,1,0,1,1,1,1,1,0,1,1,1,0],
        [3,0,0,0,0,0,0,0,0,0,0,0,0,0,3]
      ]
    }
  ]  

}